1111111111111111111111111111111111111
1..111...........................C.11
1..1.1.......1111111.1111111111111111
1.........11111111....1111...11111111
1.......11111111.....1......111111111
1....11111111.....C.........111111111
1..1111111........P.....C.11111111..1
1.111111.................1111111....1
1.1111.........C........1111111.....1
1.111111111111111111.1111111.....1111
1.111111111111111111.1111111...111111
1............1111111.1111111.11111111
1............111111...........C....11
1............1111111...............11
1111111111111111111111111111111111111
