1111111111111111111111111111111111111
100111000000000000000000000000000C011
1001010000000111111101111111111111111
1000000000111111110000111100011111111
1000000011111111000001000000111111111
100001111111100000C000000000111111111
100111111100000000P00000C011111111001
1011111100000000000000000111111100001
101111000000000C000000001111111000001
1011111111111111111101111111000001111
1011111111111111111101111111000111111
1000000000000111111101111111011111111
100000000000011111100000000000C000011
1000000000000111111100000000000000011
1111111111111111111111111111111111111
