111111111111111111111
101000001000000000001
101010101011111110001
100010100010000010001
111110101111101011101
100000101000101000001
101111101011101111111
101000001010100000101
101011111010111110101
1010C0001010100010101
101110101010101010101
100000101010001010001
111111101011111011101
1000C0101000100010001
101110101110101110111
101000100000100C10101
101011111111111010101
100010000000000010001
101010111011111111101
1P1000001000000000001
111111111111111111111
