111111111111111
111111CCC111111
11111CCCCC11111
1111CCCPCCC1111
111CCCCCCCCC111
11CCCCCCCCCCC11
1CCCCCCCCCCCCC1
11CCCCCCCCCCC11
111CCCCCCCCC111
1111CCCCCCC1111
11111CCCCC11111
111111CCC111111
111111111111111