111111111111111
111111.C.111111
11111.....11111
1111...P...1111
111.........111
11...........11
1C...11111...C1
11....111....11
111....1....111
1111.......1111
11111..1..11111
1111111C1111111
111111111111111