111111111111111
1111110C0111111
111110000011111
1111000P0001111
111000000000111
110000000000011
1C00011111000C1
110000111000011
111000010000111
111100000001111
111110000011111
1111110C0111111
111111111111111