1111111111111111111
10P1001001001000001
1011000001000001001
1001001001111101111
1001111000001C01001
1000000000000001001
1001111111111001001
1111000000000001011
100000000100000C001
1111111111111111111
