1111111111111111111
1.P1..1..1..1.....1
1.11.....1.....1..1
1..1..1..11111.1111
1..1111.....1C.1..1
1..............1..1
1..1111111111..1..1
1111...........1.11
1........1.....C..1
1111111111111111111
