1111111111111111111111111111111111
1C000000000C000000000000000C000001
1000111100000000011111000000000001
1C001000C0000000010000100000000001
100001000000000001000010000C000001
1000000111100000000000100000000001
100000000010000P000001111110000001
100000C000010000000000000010000C01
1000111111100000000000000000100001
1C00000000000000000001111111000001
100000000C000000000010000000000001
1000001111100000000000100000000001
100000000010000000C000010000000C01
1C00000000111110000000100001110001
100000C000000000000001000000000001
100000000000000000C001111110000001
1111111111111111111111111111111111
