1111111111111111111
1001001001001001001
100C001001001001001
1001001001001C01001
1001001000001001001
10000000P0000000C01
1000011111111000001
1111000000000001111
100C000101010000001
1111111111111111111
