1111111111111111111
1..1..1..1..1..1..1
1..C..1..1..1..1..1
1..1..1..1..1C.1..1
1..1..1.....1..1..1
1.......P.......C.1
1....11111111.....1
1111...........1111
1..C...1.1.1......1
1111111111111111111
