111111111111111111111
1P0000000010000000001
101111111011111011101
100000001010000010001
101011101010111010101
101000001000001010001
101011111111101011101
100010000000001000001
111011111011101111101
100010001010100000001
101110101010101011101
100010101010001000001
101011101011101111101
100000000000001000001
111111101111111011101
100000001000000000001
101011101011111110101
100010001010000000C01
111110111011101111101
100000000010100000001
111111111111111111111
