111111111111111111111111
1......................1
1......................1
1........P.............1
1......................1
1.................C....1
1......................1
1.....11111....1.1.1...1
1.....1..C1............1
1.....1...1....1C..1...1
1.........1............1
1.....1111....1.1.1....1
1......................1
1..............C.......1
1......................1
1......................1
1......................1
1......................1
1......................1
111111111..............1
1..1....1..............1
1.....1C1..............1
1..1....1.........C....1
1..111111..............1
1......................1
1......................1
111111111111111111111111
