111111111111111111111111
100000000000000000000001
100000000000000000000001
100000000P00000000000001
100000000000000000000001
100000000000000000C00001
100000000000000000000001
100000111110000101010001
100000100C10000000000001
1000001000100001C0010001
100000000010000000000001
100000111100001010100001
100000000000000000000001
100000000000000C00000001
100000000000000000000001
100000000000000000000001
100000000000000000000001
100000000000000000000001
100000000000000000000001
111111111000000000000001
100100001000000000000001
1000001C1000000000000001
100100001000000000C00001
100111111000000000000001
100000000000000000000001
100000000000000000000001
111111111111111111111111
