        1111111111111111111111111
        1.........11............1
        1.11.....111............1
        1..1......C.............1
111111111.11.....111...........C1
1C........11.....111.11111.111111
1111.111111111.111......1...1
1111.111111111.111.1.1..1...1
11......11.1.1.111......1...1
1...............11......1...1
1............C..11.1.1..1...1
11.....111.1.1.11111.1111.P.111
1111C111 111.1.1 1.1111.1...1
11111111 1111111 111111111111