        1111111111111111111111111
        1000000000110000000000001
        1011000001110000000000001
        1001000000C00000000000001
1111111110110000011100000000000C1
1C0000000011000001110111110111111
11110111111111011100000010001
11110111111111011101010010001
11000000110101011100000010001
10000000000000001100000010001
1000000000000C001101010010001
11000001110101011111011110P0111
1111C111 1110101 101111010001
11111111 1111111 111111111111